指定された	입력되는
精度	정밀도
オブジェクト	객체
組み込みクラス	내장 클래스
モジュール	모듈
例外クラス	예외 클래스
更新履歴	갱신 사항
変更履歴	변경 사항
メソッド	메소드
返す	리턴한다.
ペア	쌍
型	타입
文字列	문자열
ブロック	블록
インスタンス	인스턴스
レシーバ	리시버
呼び出し	호출
イテレータ	반복자
ブロック付きメソッド呼び	블록을 받는 메소드 호출
ブロック	블록
イテレータ	반복자
ループ	루프
抽象化	추상화
パラメータ	인자
引数	인수
拡張ライブラリ	확장 라이브러리
ソケット	소켓
パス名	패스
アドレス	주소
Unix ドメイン	Unix 도메인
IP アドレス	IP 주소
ホスト名	호스트 이름
文字列	문자열
例外	예외
返します	리턴합니다.
バッファ	버퍼
エイリアス	별칭
インタプリタ	인터프리터
汚染	영향
名前空間	네임스페이스
グローバル	전역
コマンド	명령어
用意しています	마련되어 있습니다.
改行	줄바꿈
ユーザ名	사용자명
ホスト	호스트
応答コード	응답 코드
コマンド	명령어
パスワード	패스워드
オフセット	오프셋
セキュリティ	보안
リモート	원격
別名	별칭
クッキー	쿠키
真	true
偽	false
デフォルト	기본 설정
ハッシュ	해쉬
パース	구문분석
パス	경로
ドメイン	도메인
セキュアクッキー	secure cookie
クッキー	쿠키
ライブラリ	라이브러리
クエリ	쿼리
キャラクタセット	캐릭터셋
標準出力	표준출력
ヘッダ	헤더
真偽値	boolean 값
指定	지정
ステータスコード	상태 코드
サブライブラリ	서브라이브러리
オプション	옵션
1.9 系	1.9 버전대
コマンドライン	커맨드 라인
ディレクトリ	폴더
コメント	코멘트
スペース	공백문자
引数	인수
タブ	탭
改行文字	개행문자
トークン	토큰
終了ステータス	종료상태
「」	''
セクション	섹션
パッケージ	패키지
ンポーネント	콤포넌트
コンポーネント	컴포넌트
ソースファイル	소스 파일
アプリケーション	어플리케이션
ドキュメント	문서
ソース	소스
クラス	클래스
モジュール	모듈
プレーンテキスト	플레인 텍스트
ロードマップ	로드맵
テンプレート	템플릿
イン デックスページ	인덱스 페이지
ファイル名	파일명
コマンドライン	명령행
子ノード	자식노드
リファレンス	레퍼런스
サーブレット	서블릿
呼ぶ	호출
返り値	리턴값
環境変数	환경변수
標準エラー出力	표준에러출력
リクエスト	요청
タイムアウト	타임아웃
ユーティリティ関数	유틸리티 함수
指定された	지정된
認証	인증
メンバ	맴버
リスト	목록
グループ	그룹
メンバ	구성원
作成する	만드
対応	지원
ユーザ	사용자
プロクシ	프록시
サーバ	서버
ライブラリ	라이브러리
タスク	태스크
パラメータ	인자
自身	self
ロード	읽기
モック	Mock
プロンプト	프롬프트
カスタマイズ	커스터마이즈
ローカル変数	지역 변수
リファレンス	레퍼런스
リファレンス	레퍼런스
ラッパー	래퍼
高水準	고수준
ツリー	트리
変数	변수
改行文字	줄바꿈문자
ルート	루트
EOF	EOF(end of file)
データ	데이터
エンターキー	엔터키
スレッド	쓰레드
カーソル	커서
アサーション	Assertion
インクルード	include
正規表現	정규표현
投げられた	발생된
属性	속성
常に	무조건
添付ライブラリ	표준 라이브러리
サブクラス	서브 클래스
演算	계산
単項演算子	단항연산자
扱う	다루다
リテラル	리터럴
シングルクオート	따옴표
ダブルクオート	쌍따옴표
シングルクオート	작은 따옴표
ダブルクオート	큰 따옴표
エスケープ	이스케이프
デリミタ	제한자
ヒアドキュメント	히어 도큐멘트
ダブルクオート	큰 따옴표
要素	요소
参照	참조
配列	배열
クリア	삭제	クリア
切り離す	떼어내다
待ち合わせる	기다리다
デスクリプタ	디스크립터
多言語対応	다중언어 대응
昇順	오름차순
unstable sort	불안정 정렬
デコード	디코드
エンコード	인코드
子プロセス	자식 프로세스
インスタンス	객체
スーパークラス	슈퍼 클래스
スーパークラス	부모 클래스
チェックサム	체크섬
シグナル	시그널
スレッドローカル	스레드 로컬
ローカルスコープ	로컬 스코프
ローカルスコープ	지역변수
スコープ	스코프
バックトレース	백트레이스
カレントスレッド	현재 스레드
スレッド	스레드
セーフレベル	세이프 레벨
フラグ	플래그
